R 700 700

F    81  ,114   , 71

C ./textures/zenith.xpm

NO ./textures/bricks_red1.xpm
SO ./textures/bricks_orange.xpm

WE ./textures/bricks_red2.xpm
EA ./textures/bricks_brown.xpm




     11111
    1100011
    1000001
    1000001
    1000001
    1000001
    1100011
    110001
    110001
    110001                               111111111
11111100011111111111111111111         111100000001111
10000000000000000000000000001       1110000000N00000111
110000000000000000000000001111     110000000000000000011
111000000000000000000000000001111111000000000000000000011
 11110000000000001111110000000000000000000000000000000001
    10000000000011  1000000000000000000000000000000000001
    10000000000011  1000000001111111000000000000000000011
   110000000000001111000000111     110000000000000000011
1111000000000000000000000001        1110000000000000111
1000000000000000100000111111          111100000001111
10000001111100000000011                  111000011
10000011   11000000011      111111111111111100001
1000001     100000001       100000000000000000001
1111111     111111111       111111111111111111111



